10000000001
01000000010
00000000000
00000100000
00000000000
01000000010
10000000001