10010001001
00000000000
00100000100
00000000000
00100000100
00000000000
10010001001