11000000011
00000000000
00000000000
00111011100
00000000000
00000000000
11000000011