10000000001
00000000000
00110000000
00001110000
00000001100
00000000000
10000000001