00000000000
00110000100
00000000000
00101110100
00000000000
00100001100
00000000000