00000000000
00100000000
00100000000
00100100100
00000000100
00000000100
00000000000