00000000000
00100000100
00100000100
00100100100
00100000100
00100000100
00000000000