00000000000
00100000000
00101010000
00100000000
00101010000
00100000000
00000000000